    *****
*S**    *
* *  ** *
* *  *  *
* * * * *
* *  *G *
     *  *
*  * *   
 * ** *  