*  *       
*   * * ** 
  *  *  *  
 * *   *  *
*   *g*    
  ******** 
 * * s*    
      **  *
  *   * *  
 *****   * 
       *   