 *   * **      
 * *   *  * ** 
  g* * * *  *  
 * * * * * *   
     * * *    *
 ****  *  * *  
 *   * ** * *  
   * *  * *   *
  *  ** *  *   
**   *   *  ** 
*  ****    *s  
* *     *** ** 
*  ** *   *  * 
* *   * * *    
*   *   *   * *